12 12
############
#.#.#......#
#.#.#.####.#
#.#.#....#.#
#......###.#
####.#.#.#.#
#..#.#.#.#.#
##.#.#.#.#.#
#........#.#
####.#####.#
#......#...#
######@##X##
